{
  "name": "lab-large",
  "tileSize": 20,
  "legend": {
    "#": "mur",
    " ": "sol",
    "S": "depart",
    "E": "arrivee",
    "*": "point"
  },
  "grid": [
    "###################################",
    "#S   #     #   *     #     #     E#",
    "# ### ### ### ##### ### ### ### ###",
    "#   #   #   #   * #   #   #   #   #",
    "### ### # ### ### ### ### # ### ###",
    "#   #   #   # #   #   #   #   #   #",
    "# ### ##### # # ### ### ### ### ###",
    "#   #     # # #   #   #   #   #   #",
    "### # ### # # ### # ### # ### # ###",
    "#   # #   # #   # #   # #   # #   #",
    "# ### # ### ### # ### # ### # ### #",
    "#   # #   #   # # #   #   # #   # #",
    "### # ### ### # # # ##### # ### # #",
    "#   #   #   # #   #     # #   # # #",
    "# ### ### # # ##### ### # ### # # #",
    "# #   #   # #     #   # #   # #   #",
    "# # ### ### ##### ### # ### # ### #",
    "# #   #   #   * #   # #   # #   # #",
    "# ### # ### ### ### ### # # ### # #",
    "#     #     #   *   #     #     # #",
    "###################################"
  ]
}