{
  "name": "lab-small",
  "tileSize": 24,
  "legend": {
    "#": "mur",
    " ": "sol",
    "S": "depart",
    "E": "arrivee",
    "*": "point"
  },
  "grid": [
    "###############",
    "#S   #     *  #",
    "# ## # ##### ##",
    "#    #     #  #",
    "#### ### # #  #",
    "#    * # # #  #",
    "# #### # # #  #",
    "#      # # ## #",
    "## ##### #    #",
    "#   *     ##E #",
    "###############"
  ]
}